{
  "1": 80,
  "2": 90,
  "3": 95,
  "4": 95,
  "5": 100,
  "6": 40,
  "7": 95,
  "8": 90
}
