{
  "1": 92,
  "2": 95,
  "3": 88,
  "4": 80,
  "5": 78,
  "6": 88,
  "7": 85,
  "8": 95
}
